12111111111111111111111
10000000000000000000001
11111111111111111100001
10000000000000000104001
10000000000000000100001
10000000000000000100001
10000000000000000100001
10000000000000000100001
10000000000000000100401
10000000000000000100001
10000000000000000104001
10000000000000000104001
10000000000000000100001
10000000000000000100001
10000000000000000100001
10000000000000000100001
10000000000000000104001
10000000000000000100001
10000000000000000100001
11111111111111111131111