12111111111111111111111
10100401401100010004001
10041100001140004110101
10111111101110410010101
14000000001100000000101
10100011101101101101101
10000114001141000000041
11411100041101111001101
10000000001101404000001
11111111011001010101401
11004000400411010111011
11410110111110010040011
11000100004000411101011
11141101111111011040401
11004001000011011100101
14011011041000004101101
10001011101041100000041
10004001140011041141101
10011001101111014000101
10400400000040010110001
10011111111101110410401
10000000000000000000001
11111111111111111111131