12111111111111111111111
10000010000400001000401
11110111411111100001041
10410114010001011100001
10410110010104010041111
10000000011401040104001
10100000000001400400441
10000000011111111400001
11100100010000000111111
10040100010010100100011
10100104010140010141411
10040101000001004400003
10100104010140010101011
10110011110010100100011
10000000010004000111111
11010111011111111100001
10000040000000000141401
14010100010100000100101
10004000000100010004101
11010141010111000100101
10004000000040410101441
10140001000100010000401
11111111111111111111111