12111111111111111111111
10000000000000000000001
10000100000000000100001
10000110000000001100001
10000111000000011100001
10000111100000111100001
10000104111011140100001
10001000000000000010001
10010001110401110001001
10010001310001310001001
10010001110001110001001
10140040000400004004101
10100110001110001100101
10010110001310001101001
10010000110401100001001
10001000400000400010001
10000140041114004100001
10000100000400000100001
10000014000000041000001
10000001111111110000001
10000000000000000000001
11111111111111111111111