12111111111111111111111
10000000000000000400001
10111140144101400010001
10400010111101111011001
10000010100001011041001
11110040440001010001101
11314000011040010111001
11010411111000004440001
10401104001000010001101
10100000101114010100101
10111110040011110100001
10113111010400010104111
10000004011110004110111
11101001000014000110001
11101441010010400001041
11401111114110101111011
11001001110110100000011
11100001110000101441111
11101101100110101111401
11101100110010100004001
14041004010000411041001
10000000000101000004401
11111111111111111111111